21
19
3333333333333333333
3111111113111111113
3233133313133313323
3111111111111111113
3133131333331313313
3111131113111311113
3333133303033313333
0003130004000313000
3333130333330313333
9000100333330010009
3333130333330313333
0003130000000313000
3333130333330313333
3111111113111111113
3133133313133313313
3213111118111113123
3313131333331313133
3111131113111311113
3133333313133333313
3111111111111111113
3333333333333333333